=== Cryptocoin Live Ticker ===

Contributors: coinalyze
Tags: cryptocoin, cryptocurrency, bitcoin, bitcoin cash, litecoin, ethereum, ethereum classic, monero, ripple, iota, dash, neo, ticker, price, price change
License: GPLv2 or later
License URI: http://www.gnu.org/licenses/gpl-2.0.html
Tested up to: 4.9.2


== Description ==

Display cryptocoins current price, 24 hours price change and 7 days price change on your website. You can select which coins/pairs to display. Supported pairs:

* BTC: BTCUSD, BTCEUR, BTCGBP, BTCJPY, BTCCAD, BTCAUD, BTCKRW, BTCZAR, BTCNZD, BTCINR
* BCH: BCHUSD, BCHEUR, BCHBTC, BCHKRW
* ETH: ETHUSD, ETHEUR, ETHJPY, ETHCAD, ETHAUD, ETHBTC, ETHKRW
* ETC: ETCUSD, ETCKRW
* LTC: LTCUSD, LTCEUR, LTCAUD, LTCBTC, LTCKRW
* XMR: XMRUSD, XMREUR, XMRKRW
* XRP: XRPUSD, XRPEUR, XRPKRW
* IOTA: IOTUSD
* DASH: DSHUSD, DSHKRW
* NEO: NEOUSD
* OMG: OMGUSD
* ZEC: ZECUSD, ZECKRW
* XLM: XLMUSD
* QTUM: QTUMKRW
* EOS: EOSUSD, EOSKRW, EOSBTC, EOSETH
* ADA: ADAUSD, ADABTC, ADAETH
* BAT: BATUSD, BATBTC, BATETH
* GNT: GNTUSD, GNTBTC, GNTETH
* TRX: TRXUSD, TRXBTC, TRXETH
* NANO: NANOBTC, NANOETH
* XVG: XVGUSD, XVGBTC, XVGETH
* ONT: ONTBTC, ONTETH
* POWR: POWRBTC, POWRETH 

The widget is highly customizable

* You can change the look and feel of the widget by modifying a CSS file (assets/style.css)
* You can select which pairs to display
* You can customize numbers format: decimals separator, thousands separator
* You can customize header names
* You can specify how long the pairs data are cached

Pairs data are fetched from [Coinalyze](https://coinalyze.net) . A reliable cryptocoin analysis website.

== Screenshots ==

1. Default
2. Many pairs
3. Customized sample

== Installation ==

1. Download the plugin

2. In WordPress admin interface upload and activate the plugin

3. In WordPress admin interface go to Appearance->Widgets and place the widget where you want it to be displayed
